1111111111111
1000000C00001
1010111111001
10X0X10001E01
1111111111111