1111111111111
1X01000C00001
1000011111001
1P00110000E01
1111111111111
