1111111111111
1XP100000C001
1000011111001
1000110000E01
1111111111111