1111111111111
1X0010C000001
100o011111001
100P110000E01
1111111111111